0000000#0000000
000006431000000
0000000#0000000
0000000#0000000
0000000#0000000
0000000#0000000
0000000#0000000
0000000#0000000
0000000#0000000
0000000#0000000
000000233542000
0000000#0000000
